1111111111111111
1000000000000001
1000000000000001
1000000000000001
1000000010000001
10000000CC000001
1000000011000001
1000000011000001
1000000000000001
1000000000000001
1000000000000001
10000000000P00E1
1011111111111111
10000000000Z0001
1000000ZZZZ00001
10000000Z0000001
1000000000000001
1111111111111111
