1111111111111111
1000000000000001
1000000000000001
1000000000000001
1000000000000001
1000000000000001
1000000000000001
1000000000000001
1000000000000001
1000000000000001
1000000000000001
10E00000000P0001
1111111111111111
10000000000Z0001
1000000000000001
1000000000000001
1000000000000001
1111111111111111