11111111111111111111111111111111
100000000000000000000000P1000001
10111111111111101110111110111101
10001111101111101110111110111101
10101000000000001000100000001101
10111011101011101010101111101101
10000000101000001010100010001101
11101110101111101010111110101101
10101000100001001010000100101101
10101110111011011010111101101001
10000010100000000010000001001001
10111111101111101110111110101001
10101000001000001000100000001001
10101111101011101010101111101001
10101000101000001010100010001001
10001110101111101010111110101001
11101010100001001010000101001001
10101110111011011010111011101001
10101010100000001010000001001001
10101111101111101110111110101001
10101000001000001000100000001001
10101111101011101010101111101001
10101000101000001010100010001001
10101110101111101010111110101001
10101010100001001010000101001001
10101110111011011010111011101001
10101010100000001010000001001001
10101111101111101110111110101001
10101000001000001000100000001001
10101111010111111110111101111111
10100000000100000000000000000001
11111111111111111111111111111111
