11111111111111111111111111111111
1C0000000000000000000000P0000EC1
1Z11111111111110111011111C111101
1Z001111101111101110111110111101
10101000000000001000100000001101
10111011101011101010101111101101
10000000101000001010100010001101
11101110100111101010111110101101
101010001000010010100C0100001101
10101110111011011010111011010001
1000001010000000001C000001010101
10111111101111101110111110000101
10101000001000001000100000101101
1Z101111101011101010101111101101
10100000001000001010100010001101
1000111010111110101011111C100001
11101010100001001010000100001111
10101110111011011010111001101CC1
10101010100000001010000001100001
10101111101111101110111100111011
10101000001000001000100000000011
10101111101011101010101111101011
10101000101000001010100010001011
10101110101111101000111110101001
10101010100001001010000101001101
10101110111011011010111011101101
10101010100000001010000001000001
10101111101111101110111110101011
10101000001000001000100000001C11
10101111010111111110111101111111
101000000001C0000000000000000ZZ1
11111111111111111111111111111111