11111111111111111111111111111111111111
10000000000000000000000000000000000001
10100101001000001010010000000100000001
10100100101010100010010000000100000001
1P000000000000000000000000000000000001
10001001100101111000111100001000000001
11111111111111111111111111111111111111