11111111111111111111111111111111111111
10000000000000000000000100000000000001
101001010010000010100111C1000100000001
10100100101010100010011E11100100000001
1P000000000000000000000000000000000001
10001001100101111C0C11110000100Z000001
11111111111111111111111111111111111111